##########################
#............#....#......#
#....#...................#
#....#.......#....#......#    #######
#####################.####    #.....#
                    #.#       #.....#
                    #.#       #.....#
                    #.#       #.#####
            #########.#########.#
            #...................#
            #.#####.#############
            #.#   #.#          
            #.#####.#
            #.......#
            #.......#
            #.......#
            #########