##########################
#............#....#......#
#....#............#......#
#....#.......#....#......#
##########################